
SO                      ./textures/t2.xpm
EA ./textures/t4.xpm
NO ./textures/t1.xpm
WE             ./textures/t3.xpm


F 0,250,30
C     255,   225,   100



     111 1111111  111111111111
     1000000000110000000000001
       1011000001110000000000001
     1001000000000000000000001
111111111011000001110000000001
10000000011000001110111111111111
11110111111111011100000010001
11110111111111011101010010001
11000000110101011100010010001
 10000000000000001100000010001

1000000000000001101010010001
1100001110101011111011110N0111
11110111 1110101 101111010001
1111111 111111 111111111111






